PLAYER,TEAM,GP,MIN,OREB,DREB,REB,OREB_Load,DREB_Load,REB_Load
Ivica Zubac,LAC,80,2624,300,710,1010,37.78337531486146,26.492537313432834,29.073114565342546
Karl-Anthony Towns,NYK,72,2517,212,708,920,27.604166666666668,29.475437135720234,29.02208201892745
Domantas Sabonis,SAC,70,2429,267,705,972,27.27272727272727,24.086094977792964,24.88479262672811
Nikola Jokić,DEN,70,2571,200,692,892,22.624434389140273,25.31089978054133,24.654505251520177
Josh Hart,NYK,77,2897,161,576,737,20.963541666666664,23.98001665278934,23.249211356466876
Rudy Gobert,MIN,72,2388,265,520,785,30.921820303383896,19.696969696969695,22.447812410637688
Jarrett Allen,CLE,82,2296,216,582,798,23.580786026200872,20.965417867435157,21.614301191765982
Giannis Antetokounmpo,MIL,67,2289,147,651,798,20.33195020746888,21.47097625329815,21.251664447403463
Jalen Duren,DET,78,2034,277,530,807,29.436769394261425,18.409169850642584,21.12565445026178
Bam Adebayo,MIA,78,2674,185,564,749,23.125,20.099786172487526,20.77093732667776
Walker Kessler,UTA,58,1740,266,441,707,29.392265193370164,17.172897196261683,20.357040023034838
Alperen Sengun,HOU,76,2395,262,524,786,21.833333333333332,18.621179815209665,19.581464872944693
Nikola Vučević,CHI,73,2278,178,557,735,20.721769499417928,19.16064671482628,19.516728624535315
Evan Mobley,CLE,71,2167,164,495,659,17.903930131004365,17.8314121037464,17.84940411700975
Onyeka Okongwu,ATL,74,2064,220,440,660,21.956087824351297,16.09952433223564,17.670682730923694
Yves Missi,NOP,73,1956,255,346,601,26.813880126182966,13.940370668815472,17.506554034372268
Nic Claxton,BKN,70,1882,157,358,515,19.748427672955977,16.497695852534562,17.36930860033727
Jayson Tatum,BOS,72,2624,48,575,623,5.25164113785558,21.312083024462563,17.248062015503876
Isaiah Hartenstein,OKC,57,1590,163,448,611,19.497607655502392,16.440366972477065,17.158101656837967
LeBron James,LAL,70,2444,72,474,546,9.436435124508519,19.02850260939382,16.779348494161034
Jakob Poeltl,TOR,57,1686,189,358,547,19.957761351636748,14.817880794701988,16.26523936961047
Pascal Siakam,IND,78,2548,133,407,540,18.679775280898877,15.552158960641957,16.22108741363773
Jonas Valančiūnas,SAC,81,1524,190,437,627,19.40755873340143,14.9299624188589,16.052227342549923
Zach Edey,MEM,66,1416,232,316,548,24.116424116424117,12.624850179784259,15.815295815295816
Anthony Davis,DAL,51,1705,134,456,590,14.225053078556263,15.88850174216028,15.47743966421826
Josh Giddey,CHI,70,2117,127,439,566,14.78463329452852,15.101479188166495,15.029208709506106
Alex Sarr,WAS,67,1814,124,311,435,18.702865761689292,13.846838824577027,14.953592299759366
Scottie Barnes,TOR,65,2134,109,393,502,11.510031678986273,16.266556291390728,14.927148379423134
Michael Porter Jr.,DEN,77,2593,138,402,540,15.610859728506787,14.703730797366497,14.925373134328357
Donovan Clingan,POR,67,1324,217,310,527,20.375586854460092,12.291831879460744,14.691943127962084
Deni Avdija,POR,72,2161,110,412,522,10.328638497652582,16.33624107850912,14.552550878171175
Miles Bridges,CHA,64,2029,72,409,481,7.886089813800658,16.498588140379187,14.180424528301888
Wendell Carter Jr.,ORL,68,1758,151,341,492,16.833890746934223,13.227307990690457,14.158273381294965
Myles Turner,IND,72,2174,90,381,471,12.640449438202248,14.558654948414215,14.148392910784018
Amen Thompson,HOU,69,2225,192,372,564,16.0,13.219616204690832,14.050822122571002
Kevon Looney,GSW,76,1142,185,277,462,19.892473118279568,11.722386796445198,14.029760097175828
Julius Randle,MIN,69,2226,144,343,487,16.802800466744458,12.992424242424242,13.92622247640835
Guerschon Yabusele,PHI,70,1895,134,261,395,18.87323943661972,12.247770999530736,13.90355508623724
Victor Wembanyama,SAS,46,1527,82,424,506,9.255079006772009,15.384615384615385,13.893465129049973
Naz Reid,MIN,80,2200,92,388,480,10.73512252042007,14.696969696969697,13.72605090077209
Jaden McDaniels,MIN,82,2614,129,341,470,15.052508751458577,12.916666666666668,13.440091507006006
Goga Bitadze,ORL,70,1429,167,296,463,18.61761426978818,11.481768813033359,13.323741007194245
Mark Williams,CHA,44,1171,132,315,447,14.457831325301203,12.706736587333603,13.17806603773585
James Harden,LAC,79,2789,55,401,456,6.926952141057935,14.96268656716418,13.126079447322972
Kel'el Ware,MIA,64,1422,116,357,473,14.499999999999998,12.722736992159659,13.117027176927342
Nick Richards,PHX,57,1256,148,318,466,18.294190358467244,11.530094271211022,13.064199607513316
Keegan Murray,SAC,76,2610,146,361,507,14.913176710929521,12.33344721557909,12.980030721966207
Kelly Oubre Jr.,PHI,60,2078,97,271,368,13.661971830985916,12.717034256217739,12.953185498064062
Moussa Diabaté,CHA,71,1241,187,251,438,20.481927710843372,10.125050423557887,12.912735849056602
Anthony Edwards,MIN,79,2871,61,389,450,7.117852975495915,14.734848484848484,12.868172719473836
Mason Plumlee,PHX,74,1300,116,339,455,14.338689740420271,12.291515591007977,12.755817213344548
Kyle Filipowski,UTA,72,1522,112,328,440,12.375690607734807,12.77258566978193,12.669162107687878
Draymond Green,GSW,68,1983,74,340,414,7.956989247311828,14.388489208633093,12.572122684482235
Luka Dončić,LAL,50,1769,40,369,409,5.242463958060288,14.813327980730632,12.569145666871542
Clint Capela,ATL,55,1176,174,295,469,17.365269461077844,10.79399926820344,12.556894243641231
Toumani Camara,POR,78,2548,173,277,450,16.24413145539906,10.98334655035686,12.545302481182047
Justin Champagnie,WAS,62,1341,112,239,351,16.89291101055807,10.641139804096172,12.066002062564456
Jaren Jackson Jr.,MEM,74,2207,91,326,417,9.45945945945946,13.024370755093887,12.034632034632034
Desmond Bane,ORL,69,2205,62,356,418,6.911928651059086,13.809154383242825,12.028776978417266
Dyson Daniels,ATL,76,2571,124,325,449,12.375249500998004,11.891694109037687,12.021419009370817
Santi Aldama,MEM,65,1660,94,322,416,9.771309771309772,12.864562524970037,12.005772005772005
Jusuf Nurkić,CHA,51,1063,85,313,398,9.309967141292443,12.62605889471561,11.733490566037736
Bub Carrington,WAS,82,2458,33,308,341,4.97737556561086,13.713268032056991,11.722241320041253
P.J. Washington,DAL,57,1835,82,360,442,8.70488322717622,12.543554006968641,11.594963273871983
Bennedict Mathurin,IND,72,2149,87,296,383,12.219101123595506,11.310661062285059,11.50495644337639
Quentin Grimes,PHI,75,2013,59,265,324,8.309859154929578,12.435476302205538,11.40443505807814
Christian Braun,DEN,79,2675,98,312,410,11.085972850678733,11.41185076810534,11.332227750138198
Deandre Ayton,POR,40,1206,124,282,406,11.643192488262912,11.181601903251389,11.318650683022025
Tobias Harris,DET,73,2305,65,367,432,6.9075451647183845,12.747481764501565,11.30890052356021
OG Anunoby,NYK,74,2706,97,261,358,12.630208333333334,10.86594504579517,11.293375394321767
Day'Ron Sharpe,BKN,50,907,149,181,330,18.742138364779873,8.341013824884792,11.129848229342327
Cade Cunningham,DET,70,2452,56,369,425,5.951115834218916,12.816950329975684,11.12565445026178
Tyler Herro,MIA,77,2725,35,364,399,4.375,12.972202423378477,11.064891846921796
Bobby Portis,MIL,49,1244,90,321,411,12.448132780082988,10.58707124010554,10.945406125166445
Andre Drummond,PHI,40,751,109,201,310,15.352112676056336,9.43219145940873,10.91165082717353
RJ Barrett,TOR,58,1869,61,305,366,6.441393875395987,12.624172185430464,10.88314005352364
Luke Kornet,BOS,73,1361,190,198,388,20.787746170678336,7.3387694588584145,10.741971207087486
Brook Lopez,MIL,80,2546,113,288,401,15.629322268326417,9.498680738786279,10.679094540612516
Shai Gilgeous-Alexander,OKC,76,2598,67,312,379,8.014354066985646,11.449541284403669,10.643077787138445
Kevin Durant,PHX,62,2265,23,351,374,2.843016069221261,12.726613488034808,10.485001401738156
Isaiah Stewart,DET,72,1434,130,269,399,13.815090329436769,9.343522056269538,10.44502617801047
Jalen Williams,OKC,69,2237,59,310,369,7.057416267942583,11.376146788990827,10.362257792754844
Russell Westbrook,DEN,75,2092,102,268,370,11.538461538461538,9.80248719824433,10.226644555002764
Al Horford,BOS,60,1659,79,290,369,8.643326039387308,10.748702742772425,10.215946843853821
Jaylen Brown,BOS,63,2158,82,286,368,8.971553610503284,10.600444773906597,10.188261351052049
Keldon Johnson,SAS,77,1838,112,259,371,12.641083521444695,9.39767779390421,10.186710598572212
Daniel Gafford,DAL,57,1226,155,233,388,16.454352441613587,8.118466898954704,10.178384050367262
Austin Reaves,LAL,73,2550,61,268,329,7.99475753604194,10.758731433159374,10.110633066994467
Bilal Coulibaly,WAS,59,1948,91,203,294,13.725490196078432,9.038290293855745,10.106565830182193
Keon Johnson,BKN,79,1925,63,234,297,7.9245283018867925,10.783410138248847,10.016863406408094
Precious Achiuwa,NYK,57,1170,101,216,317,13.151041666666666,8.992506244796003,10.0
Jabari Smith Jr.,HOU,57,1716,105,294,399,8.75,10.44776119402985,9.940209267563528
Paolo Banchero,ORL,46,1582,51,294,345,5.68561872909699,11.404189294026377,9.928057553956835
Brandin Podziemski,GSW,64,1716,65,260,325,6.989247311827956,11.00296233601354,9.869419981779533
Kyle Kuzma,MIL,65,1936,54,316,370,7.468879668049793,10.422163588390502,9.85352862849534
Franz Wagner,ORL,60,2023,56,286,342,6.243032329988852,11.093871217998448,9.841726618705037
Kyshawn George,WAS,68,1802,49,236,285,7.390648567119156,10.507569011576136,9.79718116191131
Royce O'Neale,PHX,75,1837,53,296,349,6.551297898640297,10.732414793328498,9.784132324081861
Ziaire Williams,BKN,63,1541,61,226,287,7.672955974842767,10.414746543778802,9.679595278246206
Jeremy Sochan,SAS,54,1364,127,225,352,14.33408577878104,8.16400580551524,9.665019220208675
Jalen Johnson,ATL,36,1284,62,297,359,6.187624750499002,10.867178924259056,9.61178045515395
Obi Toppin,IND,79,1545,56,262,318,7.865168539325842,10.011463507833398,9.552418143586662
Jalen Smith,CHI,64,962,89,268,357,10.360884749708964,9.219126246990024,9.479553903345725
Trayce Jackson-Davis,GSW,62,967,122,189,311,13.118279569892474,7.99830723656369,9.444275736410567
Derrick White,BOS,76,2574,67,274,341,7.330415754923414,10.155670867309118,9.44075304540421
John Collins,UTA,40,1221,89,238,327,9.83425414364641,9.26791277258567,9.415490930031673
Stephen Curry,GSW,70,2252,40,270,310,4.301075268817205,11.426153195090986,9.413908290312785
Brandon Clarke,MEM,64,1207,127,199,326,13.201663201663202,7.950459448661606,9.408369408369408
Jalen Green,HOU,82,2697,45,332,377,3.75,11.798152096659559,9.392127553562531
Jonathan Mogbo,TOR,63,1286,109,202,311,11.510031678986273,8.360927152317881,9.247695509961344
Jeremiah Robinson-Earl,NOP,66,1239,110,205,315,11.56677181913775,8.259468170829976,9.175648121176813
Jalen Wilson,BKN,79,2031,75,195,270,9.433962264150944,8.986175115207374,9.106239460370995
Rui Hachimura,LAL,59,1869,79,216,295,10.35386631716907,8.67121637896427,9.065765212046712
Jonathan Isaac,ORL,71,1090,120,194,314,13.377926421404682,7.525213343677269,9.035971223021583
Shaedon Sharpe,POR,72,2252,68,256,324,6.384976525821597,10.15067406819984,9.032617786451073
Tari Eason,HOU,57,1420,128,234,362,10.666666666666668,8.315565031982942,9.018435475834579
Jimmy Butler III,GSW,55,1746,125,171,296,13.440860215053762,7.236563690224291,8.98876404494382
Julian Champagnie,SAS,82,1932,67,251,318,7.562076749435666,9.107402031930334,8.731466227347612
Donovan Mitchell,CLE,71,2232,57,265,322,6.222707423580786,9.546109510086454,8.721560130010834
Adem Bona,PHI,58,905,92,153,245,12.957746478873238,7.1797278273111225,8.623724040830695
Naji Marshall,DAL,69,1919,76,252,328,8.067940552016985,8.780487804878048,8.604407135362015
Devin Booker,PHX,75,2795,76,229,305,9.394313967861558,8.303118201595359,8.550602747406783
Harrison Barnes,SAS,82,2230,97,213,310,10.948081264108351,7.728592162554426,8.511806699615596
Payton Pritchard,BOS,80,2271,102,205,307,11.159737417943107,7.598220904373611,8.499446290143965
Cameron Johnson,BKN,57,1800,54,193,247,6.7924528301886795,8.894009216589861,8.330522765598651
Aaron Wiggins,OKC,76,1744,81,214,295,9.688995215311005,7.853211009174312,8.284189834316203
Jaxson Hayes,LAL,56,1093,78,191,269,10.222804718217562,7.667603372139703,8.266748617086662
Tidjane Salaün,CHA,60,1244,70,210,280,7.667031763417305,8.471157724889068,8.254716981132075
Luguentz Dort,OKC,71,2073,89,204,293,10.645933014354068,7.486238532110091,8.228025835439484
De'Aaron Fox,SAS,62,2241,54,244,298,6.094808126410835,8.853410740203193,8.182317408017573
Mikal Bridges,NYK,82,3036,71,188,259,9.244791666666668,7.826810990840966,8.170347003154573
Stephon Castle,SAS,81,2162,89,208,297,10.045146726862303,7.547169811320755,8.15485996705107
Steven Adams,HOU,58,794,166,161,327,13.833333333333334,5.721393034825871,8.146487294469356
Chris Paul,SAS,82,2292,33,263,296,3.724604966139955,9.542815674891147,8.12740252608457
Trey Lyles,SAC,69,1350,80,236,316,8.171603677221654,8.062862999658353,8.090117767537123
Zach LaVine,SAC,74,2603,22,293,315,2.247191011235955,10.010249402118209,8.064516129032258
Jaime Jaquez Jr.,MIA,66,1368,84,206,290,10.5,7.341411261582323,8.042151968940654
Buddy Hield,GSW,82,1863,51,213,264,5.483870967741936,9.013965298349556,8.017005769814759
Lauri Markkanen,UTA,47,1476,72,206,278,7.955801104972375,8.021806853582554,8.004606968039159
Ausar Thompson,DET,59,1328,111,192,303,11.79596174282678,6.668982285515804,7.9319371727748695
Kristaps Porziņģis,BOS,42,1210,68,216,284,7.439824945295405,8.005930318754633,7.862679955703211
DeAndre Jordan,DEN,56,691,84,200,284,9.502262443438914,7.315288953913679,7.849640685461582
Trey Murphy III,NOP,53,1854,47,221,268,4.942166140904311,8.904109589041095,7.806583163413924
Tyrese Haliburton,IND,73,2450,42,216,258,5.8988764044943816,8.253725640045854,7.750075097626915
Jaylen Wells,MEM,79,2044,87,181,268,9.043659043659044,7.231322413104276,7.734487734487734
Paul George,PHI,41,1334,24,195,219,3.3802816901408446,9.150633505396527,7.708553326293559
Zach Collins,CHI,64,977,102,186,288,11.874272409778813,6.398348813209494,7.647371216144451
Taurean Prince,MIL,80,2166,34,253,287,4.702627939142462,8.344327176781002,7.6431424766977365
DeMar DeRozan,SAC,77,2768,50,248,298,5.107252298263535,8.472839084386743,7.629288274449565
Dorian Finney-Smith,LAL,63,1819,80,167,247,10.484927916120576,6.704134885588117,7.590657652120466
Nickeil Alexander-Walker,MIN,82,2073,54,211,265,6.301050175029172,7.992424242424242,7.577923934801258
Derrick Jones Jr.,LAC,77,1873,93,170,263,11.712846347607053,6.343283582089552,7.570523891767415
Thomas Bryant,IND,66,963,83,168,251,11.657303370786517,6.419564386702331,7.539801742264944
Ricky Council IV,PHI,73,1250,51,163,214,7.183098591549296,7.648991083998123,7.5325589581133405
Ryan Dunn,PHX,74,1410,92,175,267,11.372064276885045,6.345177664974619,7.485281749369217
Scotty Pippen Jr.,MEM,79,1683,65,194,259,6.756756756756757,7.750699161006793,7.474747474747474
Andrew Wiggins,MIA,60,1842,89,180,269,11.125,6.414825374198147,7.459789240155297
Kevin Porter Jr.,MIL,75,1482,42,236,278,5.809128630705394,7.783641160949868,7.403462050599201
Tyrese Martin,BKN,60,1315,58,161,219,7.29559748427673,7.419354838709677,7.386172006745364
Matas Buzelis,CHI,80,1511,55,223,278,6.402793946449361,7.671138630890953,7.381837493361656
Jaylin Williams,OKC,47,784,48,214,262,5.741626794258373,7.853211009174312,7.357483852850323
Jrue Holiday,BOS,62,1896,76,189,265,8.315098468271334,7.005189028910304,7.336655592469546
Keyonte George,UTA,67,2108,26,227,253,2.8729281767955803,8.83956386292835,7.28476821192053
Georges Niang,ATL,79,1697,47,225,272,4.69061876247505,8.232711306256862,7.282463186077644
Coby White,CHI,74,2450,25,248,273,2.910360884749709,8.531131750945994,7.24907063197026
Damian Lillard,MIL,58,2093,29,243,272,4.011065006915629,8.014511873350925,7.243675099866845
Kris Dunn,LAC,74,1783,53,198,251,6.675062972292191,7.388059701492537,7.22510074841681
Chet Holmgren,OKC,32,877,48,209,257,5.741626794258373,7.669724770642201,7.217073855658524
Jamal Murray,DEN,67,2418,45,216,261,5.090497737556561,7.900512070226775,7.213930348258707
Ochai Agbaji,TOR,64,1739,61,181,242,6.441393875395987,7.491721854304635,7.195955991674101
Zaccharie Risacher,ATL,75,1843,86,182,268,8.582834331337326,6.659348701061105,7.17536813922356
Dereck Lively II,DAL,36,833,104,166,270,11.040339702760086,5.7839721254355405,7.08289611752361
Tristan da Silva,ORL,74,1629,73,172,245,8.138238573021182,6.671838634600466,7.0503597122302155
Devin Vassell,SAS,64,1983,34,221,255,3.837471783295711,8.018867924528301,7.00164744645799
Haywood Highsmith,MIA,74,1818,72,180,252,9.0,6.414825374198147,6.988352745424292
De'Andre Hunter,CLE,64,1740,44,214,258,4.8034934497816595,7.708933717579251,6.9880823401950165
Jordan Poole,WAS,68,2001,31,172,203,4.675716440422323,7.658058771148708,6.978343073221039
Ben Simmons,LAC,51,1120,47,194,241,5.919395465994962,7.2388059701492535,6.9372481289579735
Jarace Walker,IND,75,1187,25,204,229,3.51123595505618,7.795185326709973,6.878942625413037
Dillon Brooks,HOU,75,2388,75,200,275,6.25,7.107320540156362,6.851021425012456
LaMelo Ball,CHA,47,1505,47,185,232,5.147864184008762,7.462686567164178,6.839622641509433
Aaron Gordon,DEN,51,1447,80,167,247,9.049773755656108,6.108266276517922,6.826976229961304
Max Christie,DAL,78,2127,38,220,258,4.033970276008493,7.665505226480835,6.76810073452256
Kenrich Williams,OKC,69,1132,65,176,241,7.775119617224881,6.458715596330275,6.767761864644763
Isaiah Collier,UTA,71,1839,32,203,235,3.535911602209945,7.904984423676012,6.766484307515117
Dean Wade,CLE,59,1253,51,198,249,5.567685589519651,7.132564841498559,6.7443120260021665
Chris Boucher,TOR,50,862,70,154,224,7.391763463569166,6.3741721854304645,6.660719595599167
Dalton Knecht,LAL,78,1494,37,179,216,4.849279161205767,7.18586912886391,6.637984019668101
Jake LaRavia,SAC,66,1349,90,169,259,9.19305413687436,5.773829859924838,6.630824372759856
Anthony Black,ORL,78,1887,52,178,230,5.797101449275362,6.904577191621413,6.618705035971223
Terry Rozier,MIA,64,1658,44,194,238,5.5,6.9137562366357805,6.600110926234054
Jonathan Kuminga,GSW,47,1144,56,161,217,6.021505376344086,6.813372831146847,6.589735803218949
Orlando Robinson,TOR,44,770,89,131,220,9.398099260823653,5.422185430463576,6.541778174249183
Neemias Queta,BOS,62,863,89,147,236,9.737417943107221,5.448480355819125,6.533776301218161
Donte DiVincenzo,MIN,62,1606,32,196,228,3.7339556592765457,7.424242424242425,6.519874177866742
Drew Eubanks,LAC,61,746,60,166,226,7.5566750629722925,6.1940298507462686,6.505469199769717
Andrew Nembhard,IND,65,1881,34,182,216,4.775280898876404,6.954528085594191,6.488434965455092
Klay Thompson,DAL,72,1965,44,202,246,4.670912951167728,7.038327526132404,6.453305351521512
Peyton Watson,DEN,68,1656,47,186,233,5.316742081447964,6.803218727139722,6.440022111663903
Cason Wallace,OKC,68,1876,71,158,229,8.492822966507177,5.798165137614679,6.430777871384443
Trae Young,ATL,76,2739,36,200,236,3.592814371257485,7.317965605561653,6.318607764390897
Kawhi Leonard,LAC,37,1180,35,184,219,4.408060453400504,6.865671641791045,6.303972366148532
Kyrie Irving,DAL,50,1804,60,180,240,6.369426751592357,6.2717770034843205,6.295907660020986
Patrick Williams,CHI,63,1576,43,194,237,5.005820721769499,6.673546611627107,6.293149229952204
Zion Williamson,NOP,30,857,76,140,216,7.991587802313354,5.640612409347301,6.291872997378387
Cody Martin,PHX,53,1173,53,171,224,6.551297898640297,6.200145032632342,6.279786935800392
Nicolas Batum,LAC,78,1367,47,171,218,5.919395465994962,6.380597014925374,6.275187104202648
Malik Monk,SAC,65,2054,30,215,245,3.0643513789581207,7.345404851383669,6.272401433691756
Oso Ighodaro,PHX,61,1046,66,156,222,8.15822002472188,5.656272661348803,6.223717409587889
Corey Kispert,WAS,61,1602,36,145,181,5.429864253393665,6.455921638468388,6.22206943966999
Sam Hauser,BOS,71,1541,44,180,224,4.814004376367615,6.6716085989621945,6.2015503875969
CJ McCollum,NOP,56,1832,42,170,212,4.416403785488959,6.8493150684931505,6.175356830760268
Tyrese Maxey,PHI,52,1960,15,159,174,2.112676056338028,7.461285781323322,6.124604012671594
Noah Clowney,BKN,46,1042,43,138,181,5.4088050314465415,6.3594470046082945,6.104553119730186
Karlo Matković,NOP,42,791,64,145,209,6.729758149316509,5.842062852538275,6.087969705796679
Richaun Holmes,WAS,31,534,62,115,177,9.351432880844646,5.120213713268032,6.084565142660709
Brice Sensabaugh,UTA,71,1432,42,168,210,4.640883977900553,6.5420560747663545,6.046645551396487
Kelly Olynyk,NOP,44,891,62,144,206,6.5194532071503675,5.801772763900081,6.000582580833091
Ja Morant,MEM,50,1519,34,171,205,3.5343035343035343,6.831801837794646,5.916305916305916
Javonte Green,CLE,68,1258,59,159,218,6.441048034934497,5.727665706051873,5.90465872156013
Jalen Brunson,NYK,65,2301,27,160,187,3.515625,6.661115736885928,5.899053627760252
Cole Anthony,MEM,67,1234,46,158,204,4.781704781704782,6.3124250898921295,5.887445887445888
Jabari Walker,POR,60,749,59,152,211,5.539906103286385,6.026962727993656,5.88235294117647
Max Strus,CLE,50,1273,53,164,217,5.786026200873363,5.9077809798270895,5.877573131094258
Dejounte Murray,NOP,31,1012,17,183,200,1.7875920084121977,7.373086220789686,5.825808330905914
T.J. McConnell,IND,79,1415,44,149,193,6.179775280898876,5.693542223920519,5.797536797837188
Darius Garland,CLE,75,2301,47,167,214,5.131004366812228,6.015850144092219,5.796316359696641
Moses Moody,GSW,74,1649,52,137,189,5.591397849462366,5.797714769360981,5.739447312481021
Gradey Dick,TOR,54,1587,44,149,193,4.646251319957761,6.167218543046358,5.738923580136782
Kyle Anderson,MIA,61,1002,53,153,206,6.625,5.452601568068425,5.712701053799223
Ronald Holland II,DET,81,1266,40,178,218,4.250797024442083,6.182702327196943,5.706806282722513
Simone Fontecchio,DET,75,1237,52,163,215,5.526036131774708,5.661688086141021,5.6282722513089
Gary Payton II,GSW,62,927,53,132,185,5.698924731182796,5.586119339822259,5.617977528089887
Malik Beasley,DET,82,2283,47,167,214,4.994686503719448,5.800625217089267,5.602094240837696
Jarred Vanderbilt,LAL,36,581,68,114,182,8.91218872870249,4.576475311120031,5.593116164720344
Scoot Henderson,POR,66,1759,52,146,198,4.882629107981221,5.789056304520222,5.5199330917201
Fred VanVleet,HOU,60,2111,32,189,221,2.666666666666667,6.7164179104477615,5.5057299451918285
Isaiah Joe,OKC,74,1604,41,155,196,4.904306220095694,5.688073394495413,5.5040718899185626
Tyus Jones,PHX,81,2174,40,156,196,4.944375772558715,5.656272661348803,5.494813568825344
Spencer Dinwiddie,DAL,79,2136,18,191,209,1.910828025477707,6.655052264808363,5.482686253934943
Norman Powell,LAC,60,1958,21,169,190,2.644836272040302,6.3059701492537314,5.469199769717904
D'Angelo Russell,BKN,58,1480,20,142,162,2.515723270440252,6.5437788018433185,5.463743676222597
Kevin Huerter,CHI,69,1679,30,175,205,3.4924330616996504,6.019951840385277,5.443441317047265
Grayson Allen,PHX,64,1544,34,160,194,4.202719406674907,5.8013052936910805,5.43874404261284
Caris LeVert,ATL,64,1596,41,162,203,4.091816367265469,5.92755214050494,5.435073627844712
Keon Ellis,SAC,80,1948,60,152,212,6.128702757916241,5.193030406559617,5.427547363031234
Trendon Watford,BKN,44,913,37,123,160,4.654088050314465,5.668202764976959,5.396290050590219
Aaron Nesmith,IND,45,1122,37,141,178,5.196629213483146,5.387848681696599,5.346951036347251
Terance Mann,ATL,67,1414,68,131,199,6.786427145708583,4.793267471642883,5.327978580990629
Ben Sheppard,IND,63,1230,44,133,177,6.179775280898876,5.082155139472679,5.316911985581255
Johnny Juzang,UTA,64,1270,42,142,184,4.640883977900553,5.529595015576324,5.298013245033113
Luke Kennard,MEM,65,1472,37,146,183,3.8461538461538463,5.833000399520576,5.2813852813852815
Anfernee Simons,POR,70,2292,25,164,189,2.3474178403755865,6.502775574940524,5.269027042096459
Jericho Sims,MIL,53,631,71,126,197,9.820193637621024,4.155672823218998,5.246338215712384
Gui Santos,GSW,56,762,72,100,172,7.741935483870968,4.231908590774439,5.223200728818706
Justin Edwards,PHI,44,1155,46,102,148,6.478873239436619,4.786485218207415,5.20943329813446
Mike Conley,MIN,71,1756,32,150,182,3.7339556592765457,5.681818181818182,5.204460966542751
Dennis Schröder,DET,75,2105,27,171,198,2.869287991498406,5.939562348037513,5.183246073298429
Sandro Mamukelashvili,SAS,61,681,62,125,187,6.997742663656885,4.535558780841799,5.13454146073586
Miles McBride,NYK,64,1593,47,114,161,6.119791666666666,4.746044962531224,5.078864353312302
Kris Murray,POR,69,1040,76,106,182,7.136150234741784,4.203013481363997,5.0738778923891825
Josh Green,CHA,68,1888,56,116,172,6.133625410733845,4.679306171843485,5.070754716981132
Nikola Jović,MIA,46,1156,26,154,180,3.25,5.48823948681397,4.9916805324459235
Bradley Beal,PHX,53,1702,34,143,177,4.202719406674907,5.184916606236404,4.96215306980656
Collin Sexton,UTA,63,1758,60,111,171,6.629834254143646,4.322429906542056,4.923697091851426
Kentavious Caldwell-Pope,MEM,77,2279,33,136,169,3.4303534303534304,5.433479824210947,4.8773448773448775
Andre Jackson Jr.,MIL,67,980,65,117,182,8.990318118948824,3.8588390501319263,4.846870838881491
Tim Hardaway Jr.,DET,77,2153,18,165,183,1.9128586609989375,5.731156651615144,4.790575916230367
Bruce Brown,NOP,41,922,40,124,164,4.206098843322819,4.99597099113618,4.7771628313428485
Daniel Theis,NOP,38,621,44,120,164,4.6267087276550996,4.8348106365834,4.7771628313428485
Ja'Kobe Walter,TOR,52,1103,59,101,160,6.2302006335797255,4.180463576158941,4.757656853999405
Micah Potter,UTA,38,705,43,121,164,4.751381215469613,4.711838006230529,4.72214224013821
Khris Middleton,WAS,37,843,13,124,137,1.9607843137254901,5.520926090828139,4.709522172567892
Jamison Battle,TOR,59,1042,37,121,158,3.907074973600845,5.008278145695364,4.6981861433244125
Ty Jerome,CLE,70,1392,50,123,173,5.458515283842795,4.430835734870317,4.685807150595883
Caleb Martin,DAL,45,1218,53,124,177,5.626326963906582,4.320557491289199,4.643231899265477
Amir Coffey,LAC,72,1748,32,129,161,4.030226700251889,4.813432835820895,4.634427173287277
AJ Green,MIL,73,1659,18,156,174,2.4896265560165975,5.145118733509235,4.633821571238348
Duncan Robinson,MIA,74,1786,18,149,167,2.25,5.310049893086244,4.631170271769274
Davion Mitchell,MIA,74,2027,35,132,167,4.375,4.704205274411975,4.631170271769274
Jordan Hawkins,NOP,56,1320,25,133,158,2.6288117770767614,5.358581788879936,4.6023885814156715
Bogdan Bogdanović,LAC,54,1348,24,135,159,3.022670025188917,5.037313432835821,4.576856649395509
Jerami Grant,POR,47,1524,26,137,163,2.4413145539906105,5.432196669310072,4.544187343183719
Quinten Post,GSW,42,686,35,113,148,3.763440860215054,4.782056707575117,4.49438202247191
Julian Phillips,CHI,79,1123,67,102,169,7.799767171129219,3.508771929824561,4.487519915029209
Gary Trent Jr.,MIL,74,1893,20,148,168,2.7662517289073305,4.881266490765172,4.474034620505992
Tristan Vukcevic,WAS,35,513,26,104,130,3.9215686274509802,4.630454140694568,4.46888965280165
Alex Caruso,OKC,54,1041,38,121,159,4.545454545454546,4.440366972477064,4.465037910699242
John Konchar,MEM,46,558,37,114,151,3.8461538461538463,4.554534558529764,4.357864357864358
Bismack Biyombo,SAS,28,528,43,115,158,4.853273137697517,4.172714078374455,4.3382756727073035
Ayo Dosunmu,CHI,46,1394,26,135,161,3.026775320139697,4.643962848297214,4.275092936802974
Moritz Wagner,ORL,30,564,40,108,148,4.459308807134894,4.189294026377036,4.258992805755395
Sam Merrill,CLE,71,1401,38,119,157,4.148471615720524,4.286743515850144,4.252437703141928
Mo Bamba,NOP,32,413,32,113,145,3.3648790746582544,4.552780016116036,4.223711039906787
Vít Krejčí,ATL,57,1153,22,134,156,2.19560878243513,4.903036955726308,4.176706827309237
Charles Bassey,SAS,36,376,56,96,152,6.320541760722348,3.483309143686502,4.173531026908292
Jalen Suggs,ORL,35,1002,23,118,141,2.564102564102564,4.577191621411948,4.057553956834532
Tosan Evbuomwan,BKN,28,665,32,88,120,4.0251572327044025,4.055299539170507,4.0472175379426645
DaQuan Jeffries,CHA,47,1071,37,98,135,4.052573932092004,3.953206938281565,3.9799528301886795
Jose Alvarado,NOP,56,1366,27,109,136,2.8391167192429023,4.391619661563255,3.961549665016021
Julian Strawther,DEN,65,1384,17,125,142,1.9230769230769231,4.57205559619605,3.924820342730791
Brandon Boston,NOP,42,993,28,106,134,2.9442691903259726,4.27074939564867,3.903291581706962
Jared Butler,PHI,60,1044,25,85,110,3.5211267605633805,3.988737681839512,3.8718760999648008
Brandon Miller,CHA,27,924,25,106,131,2.7382256297918945,4.275917708753529,3.8620283018867925
Nick Smith Jr.,CHA,60,1369,13,115,128,1.4238773274917853,4.63896732553449,3.7735849056603774
Dalano Banton,POR,67,1120,30,105,135,2.8169014084507045,4.163362410785091,3.763590744354614
Cam Whitmore,HOU,51,827,36,115,151,3.0,4.0867093105899075,3.761833582461385
Jay Huff,MEM,64,748,30,99,129,3.118503118503119,3.9552536955653217,3.722943722943723
Mouhamed Gueye,ATL,33,533,44,95,139,4.39121756487026,3.4760336626417856,3.7215528781793843
Tristan Thompson,CLE,40,328,32,102,134,3.4934497816593884,3.674351585014409,3.629469122426869
Colin Castleton,TOR,26,432,53,69,122,5.59662090813094,2.8559602649006623,3.6277133511745467
KJ Martin,UTA,43,912,30,95,125,3.314917127071823,3.699376947040498,3.599193780593147
Taj Gibson,CHA,37,409,51,69,120,5.585980284775466,2.7833803953206937,3.5377358490566038
Isaac Okoro,CLE,55,1053,49,81,130,5.349344978165939,2.9178674351585014,3.5211267605633805
Immanuel Quickley,TOR,33,918,16,101,117,1.689545934530095,4.180463576158941,3.479036574487065
Jordan Goodwin,LAL,29,543,38,74,112,4.980340760157274,2.9706945002007226,3.4419176398279046
Alec Burks,MIA,49,864,15,109,124,1.875,3.8845331432644334,3.438713255684969
Jamal Shead,TOR,75,1467,30,85,115,3.167898627243928,3.5182119205298013,3.4195658638120725
Jock Landale,HOU,42,500,56,81,137,4.666666666666667,2.878464818763326,3.4130543099152963
Dillon Jones,OKC,54,552,30,91,121,3.588516746411483,3.339449541284404,3.3979219320415615
Jordan Clarkson,UTA,37,962,25,93,118,2.7624309392265194,3.6214953271028034,3.3976389288799305
Seth Curry,CHA,68,1062,24,89,113,2.628696604600219,3.5901573215006053,3.331367924528302
Josh Okogie,CHA,40,625,45,68,113,4.928806133625411,2.743041549011698,3.331367924528302
Olivier-Maxence Prosper,DAL,52,584,44,82,126,4.670912951167728,2.857142857142857,3.305351521511018
Dalen Terry,CHI,73,987,38,86,124,4.423748544819558,2.958376332989336,3.2926181625066384
Robert Williams III,POR,20,351,35,83,118,3.286384976525822,3.2910388580491676,3.2896570950655146
Cameron Payne,NYK,72,1090,14,90,104,1.8229166666666667,3.746877601998335,3.2807570977917986
Kai Jones,DAL,40,468,40,85,125,4.246284501061571,2.961672473867596,3.2791185729275973
Cody Williams,UTA,50,1060,27,86,113,2.983425414364641,3.348909657320872,3.2536711776562046
Jaden Ivey,DET,30,898,40,84,124,4.250797024442083,2.917679749913164,3.2460732984293195
Trey Jemison III,LAL,38,392,44,61,105,5.766710353866317,2.448815736651947,3.2267977873386604
Paul Reed,DET,45,438,40,83,123,4.250797024442083,2.882945467176103,3.2198952879581153
KJ Simpson,CHA,36,842,39,70,109,4.271631982475356,2.8237192416296892,3.2134433962264155
Shake Milton,LAL,57,836,31,73,104,4.062909567496723,2.93054997992774,3.196066379840197
Lonzo Ball,CHI,35,777,25,93,118,2.910360884749709,3.199174406604747,3.1332979288369622
Malcolm Brogdon,WAS,24,564,21,70,91,3.167420814479638,3.1166518254674975,3.1282227569611547
Dwight Powell,DAL,55,551,47,71,118,4.989384288747346,2.473867595818815,3.0954879328436515
Tre Jones,CHI,46,905,31,85,116,3.608847497089639,2.923976608187134,3.0801911842804035
Kessler Edwards,DAL,40,608,22,93,115,2.335456475583864,3.2404181184668994,3.0167890870933896
Colby Jones,WAS,39,515,21,66,87,3.167420814479638,2.9385574354407837,2.9907184599518737
Maxi Kleber,LAL,34,637,25,70,95,3.2765399737876804,2.810116419108792,2.919483712354026
Alex Len,LAL,46,380,38,57,95,4.980340760157274,2.2882376555600157,2.919483712354026
Bol Bol,PHX,36,448,20,84,104,2.4721878862793574,3.0456852791878175,2.915615363050182
Jae'Sean Tate,HOU,52,588,50,67,117,4.166666666666666,2.380952380952381,2.914798206278027
Pat Connaughton,MIL,41,603,19,90,109,2.627939142461964,2.9683377308707124,2.902796271637816
Lindy Waters III,DET,52,778,20,90,110,2.1253985122210417,3.126085446335533,2.8795811518324608
Ryan Rollins,MIL,56,820,21,87,108,2.904564315352697,2.8693931398416885,2.8761651131824233
Vince Williams Jr.,MEM,27,499,22,76,98,2.2869022869022873,3.0363563723531763,2.8282828282828283
Christian Koloko,LAL,37,342,35,57,92,4.587155963302752,2.2882376555600157,2.8272894898586354
Gabe Vincent,LAL,72,1527,20,72,92,2.621231979030144,2.890405459654757,2.8272894898586354
Wendell Moore Jr.,CHA,36,499,30,65,95,3.285870755750274,2.6220250100847116,2.8007075471698113
Cam Thomas,BKN,25,781,15,68,83,1.8867924528301887,3.133640552995392,2.799325463743676
Larry Nance Jr.,ATL,24,463,23,80,103,2.2954091816367264,2.9271862422246615,2.7576974564926373
Talen Horton-Tucker,CHI,58,724,19,81,100,2.211874272409779,2.786377708978328,2.655337227827934
GG Jackson,MEM,29,459,27,65,92,2.806652806652807,2.596883739512585,2.655122655122655
Jaylon Tyson,CLE,47,453,37,59,96,4.039301310043668,2.1253602305475505,2.600216684723727
Svi Mykhailiuk,UTA,38,760,22,68,90,2.430939226519337,2.64797507788162,2.591419522027066
Duop Reath,POR,46,469,44,48,92,4.131455399061033,1.9032513877874702,2.564817396152774
A.J. Lawson,TOR,26,486,20,66,86,2.1119324181626187,2.7317880794701987,2.55724055902468
Pelle Larsson,MIA,55,782,28,64,92,3.5000000000000004,2.2808267997148968,2.5513033832501386
Vasilije Micic,PHX,41,785,20,69,89,2.4721878862793574,2.5018129079042786,2.4950939164564057
Zeke Nnaji,DEN,57,608,33,57,90,3.733031674208145,2.0848573518653986,2.4875621890547266
Jamal Cain,NOP,37,502,27,58,85,2.8391167192429023,2.3368251410153102,2.475968540635013
Marcus Smart,WAS,34,680,18,54,72,2.7149321266968327,2.404274265360641,2.4750773461670676
Kyle Lowry,PHI,35,659,11,56,67,1.5492957746478873,2.627874237447208,2.3583245336149243
Jaden Hardy,DAL,57,907,9,80,89,0.9554140127388535,2.7874564459930316,2.334732423924449
Garrison Mathews,ATL,47,830,13,74,87,1.2974051896207583,2.707647274057812,2.3293172690763053
Elfrid Payton,NOP,24,511,15,64,79,1.5772870662460567,2.5785656728444803,2.3011942907078358
Dominick Barlow,ATL,35,375,35,50,85,3.493013972055888,1.8294914013904133,2.2757697456492636
Ousmane Dieng,OKC,37,405,18,63,81,2.15311004784689,2.311926605504587,2.274641954507161
Herbert Jones,NOP,20,648,22,56,78,2.3133543638275498,2.2562449637389204,2.2720652490533064
Anthony Gill,WAS,51,398,18,48,66,2.7149321266968327,2.13713268032057,2.2688209006531452
Lonnie Walker IV,PHI,20,477,6,57,63,0.8450704225352111,2.674800563115908,2.2175290390707496
Collin Gillespie,PHX,33,461,22,56,78,2.719406674907293,2.030456852791878,2.1867115222876365
Caleb Houstan,ORL,58,788,19,56,75,2.118171683389075,2.1722265321955003,2.158273381294964
Hunter Tyson,DEN,51,400,25,53,78,2.828054298642534,1.9385515727871252,2.155887230514096
Johnny Furphy,IND,50,379,23,48,71,3.2303370786516856,1.834161253343523,2.132772604385701
Cory Joseph,ORL,50,612,17,57,74,1.89520624303233,2.2110162916989915,2.1294964028776975
Jeff Dowtin Jr.,PHI,41,621,12,48,60,1.6901408450704223,2.252463632097607,2.1119324181626187
David Roddy,HOU,33,410,13,71,84,1.0833333333333335,2.523098791755508,2.092675635276532
Delon Wright,NYK,40,635,27,39,66,3.515625,1.623646960865945,2.082018927444795
Cam Reddish,LAL,33,589,17,49,66,2.2280471821756227,1.9670814933761542,2.028272894898586
AJ Johnson,WAS,29,638,8,51,59,1.206636500754148,2.2707034728406055,2.0281883808869026
Torrey Craig,BOS,26,314,27,46,73,2.954048140043764,1.704966641957005,2.0210409745293467
Jett Howard,ORL,60,701,20,50,70,2.229654403567447,1.9394879751745537,2.014388489208633
Jared McCain,PHI,23,592,13,43,56,1.8309859154929577,2.017832003754106,1.9711369236184444
Jalen Pickett,DEN,49,666,15,56,71,1.6968325791855203,2.04828090709583,1.9624101713653954
Rayan Rupert,POR,52,460,26,44,70,2.4413145539906105,1.7446471054718478,1.9514914970727628
Devin Carter,SAC,36,396,19,57,76,1.940755873340143,1.9473864024598566,1.9457245263696878
Aaron Holiday,HOU,62,792,13,65,78,1.0833333333333335,2.3098791755508175,1.9431988041853512
Reed Sheppard,HOU,52,654,16,62,78,1.3333333333333335,2.2032693674484722,1.9431988041853512
Landry Shamet,NYK,50,762,11,50,61,1.4322916666666665,2.0815986677768525,1.9242902208201893
Jordan Walsh,BOS,52,403,23,46,69,2.516411378555799,1.704966641957005,1.910299003322259
Ajay Mitchell,OKC,36,597,18,50,68,2.15311004784689,1.834862385321101,1.9095759618084809
Monté Morris,PHX,45,571,12,55,67,1.4833127317676145,1.9941986947063088,1.8783291281188674
Maxwell Lewis,BKN,28,328,18,37,55,2.2641509433962264,1.705069124423963,1.854974704890388
Gary Harris,ORL,48,711,20,44,64,2.229654403567447,1.7067494181536074,1.8417266187050358
Antonio Reeves,NOP,44,660,18,45,63,1.8927444794952681,1.813053988718775,1.8351296242353627
Craig Porter Jr.,CLE,51,513,19,48,67,2.074235807860262,1.729106628242075,1.8147345612134345
Marcus Sasser,DET,57,811,18,51,69,1.9128586609989375,1.7714484195901354,1.8062827225130889
Baylor Scheierman,BOS,31,384,19,46,65,2.0787746170678334,1.704966641957005,1.7995570321151715
Blake Wesley,SAS,58,683,17,44,61,1.9187358916478554,1.5965166908563133,1.6749038989566172
Jaden Springer,UTA,43,365,17,41,58,1.8784530386740332,1.5965732087227413,1.6700259141952203
Jordan Miller,LAC,37,420,23,35,58,2.8967254408060454,1.3059701492537312,1.6695451928612552
Eric Gordon,PHI,39,769,8,38,46,1.1267605633802817,1.7832003754106054,1.6191481872580078
Trevelin Queen,ORL,31,430,26,28,54,2.898550724637681,1.0861132660977502,1.553956834532374
Brandon Williams,DAL,33,487,12,46,58,1.2738853503184715,1.6027874564459932,1.521511017838405
Jaylen Clark,MIN,40,522,26,27,53,3.0338389731621938,1.0227272727272727,1.5155847869602517
Reggie Jackson,PHI,31,384,8,34,42,1.1267605633802817,1.5954950727358048,1.478352692713833
Isaac Jones,SAC,40,304,22,35,57,2.247191011235955,1.1957635804578066,1.4592933947772657
Jeff Green,HOU,32,396,11,47,58,0.9166666666666666,1.6702203269367448,1.4449427005480817
Rob Dillingham,MIN,49,516,12,38,50,1.4002333722287048,1.4393939393939394,1.4297969688304262
Malaki Branham,SAS,47,427,7,44,51,0.7900677200902935,1.5965166908563133,1.400329489291598
Terrence Shannon Jr.,MIN,32,339,10,37,47,1.1668611435239207,1.4015151515151516,1.3440091507006005
Keaton Wallace,ATL,31,501,7,43,50,0.6986027944111777,1.5733626051957557,1.3386880856760375
Quenton Jackson,IND,28,381,14,30,44,1.9662921348314606,1.146350783339702,1.321718233703815
Reece Beekman,BKN,36,469,13,26,39,1.6352201257861636,1.19815668202765,1.315345699831366
Jevon Carter,CHI,36,321,4,35,39,0.46565774155995343,1.2039903680770554,1.0355815188528943
Danté Exum,DAL,20,372,4,29,33,0.42462845010615713,1.0104529616724738,0.8656873032528857
Jordan McLaughlin,SAS,46,314,6,24,30,0.6772009029345373,0.8708272859216255,0.8237232289950577
Patty Mills,LAC,29,321,4,18,22,0.5037783375314862,0.6716417910447761,0.6332757628094415
Doug McDermott,SAC,42,342,3,19,22,0.30643513789581206,0.6491288008199522,0.5632360471070148
